BBBBBBBBBBBBBBBBBBBBBBFBB
BBXXXXXXBBBBBXXXXXXXXBXBB
BBBBBBBXXXXXXXBBBBBBXXXBB
BBBBBBBBXXBBBBBBBBBBBBBBB
BBXXXXXXXXXXXXXXXBBXXXXBB
BBBBBBBBBBBBBBBXXBBXBBXBB
BBBBXXXXXXXBBBBXXBBXBBXBB
BBBBXXBBBXXBXXXXXXXXBBXBB
BBBBBXXBBXXBXXXBBBBBBBXBB
BBBXXXBBBBXBBBBBXXXXXXXBB
BBXXXBBXXXXXXXXXXBBBBXXBB
BBXXXBBXXXXXBBXXXBBBBXXBB
BBXXXBBBBBXXXXXXXBBBBBBBB
BBXXXBBBBBBBXXXXXBBXXXXBB
BBXXXXXXXXXXBBBBBBBXXBBBB
BBBBBBBBBBXXXXBBBBBXXBBBB
SXXXXXXXXXXXXXXXXXXXXBBBB
BBBBBBBBBBBBBBBBBBBBBBBBB